10 10 3
8 2
9 9
..##......
.###......
..#.......
...##..##.
.#..##..#.
##...#..#.
.#....###.
#..#......
.#..#.#..#
..###.....