9 8 3
3 0
7 7
.#######
.#.....#
.#.#.###
...#...#
.#.###.#
.#.....#
.#######
........
.#######