6 6
0 0
5 5
..####
#....#
#.##.#
#.#..#
#.#..#
#.##.#
