12 12
0 0
11 11
..##########
#......#...#
#.#.####.#.#
#.#......#.#
#.#.######.#
#.#....#.#.#
#.#.#....#.#
#.#.#.##.#.#
#.#......#.#
#.##.#.#####
#....#.....#
##########.#