10 10 3
0 3
6 7
..#.......
.###...#..
.#.#.#....
.#...##..#
##...##...
.#..#..#..
#...##...#
.#.....###
#...#...##
...##.....