9 12 5
5 5
8 11
............
.#..........
.#..........
.#..........
.#..........
.#..........
.#..........
.###########
............